Correct Answer,Last Correct Answer Date,Streak,Priority,Other Question Padding,Overall Score,Total Priority
m,2024-08-24 13:25:09.591686,2,7,2,3,9
s,2024-08-24 13:22:33.733728,-1,10,0,0,19
a,2024-08-24 12:42:08.110471,4,1,-18,9,20
eÌ„,2024-08-24 13:23:29.200427,2,7,-1,3,27
t,,-2,13,1,-3,40
r,,0,10,-8,0,50
d,,0,10,-8,0,60
i,,0,10,-8,0,70
th,,0,10,0,0
c,2024-08-24 12:59:48.407777,3,2,-9,8,72
n,,0,10,0,0
b,2024-08-24 13:00:39.725572,1,20,-8,-10,92
d,2024-08-24 12:59:09.741728,3,7,-10,3,99
